Abyssal Blade=Skull Basher+Vanguard
Aeon Disk=Vitality Booster+Energy Booster
Aether Lens=Energy Booster+Void Stone
Aghanim's Scepter=Point Booster+Ogre Club+Blade of Alacrity+Staff of Wizardry
Aghanim's Shard=Point Booster
Arcane Blink=Blink Dagger+Mystic Staff
Arcane Boots=Boots of Speed+Energy Booster
Armlet of Mordiggian=Helm of Iron Will+Gloves of Haste+Blades of Attack
Assault Cuirass=Platemail+Hyperstone+Chainmail
Battle Fury=Claymore+Broadsword+Perseverance+Quelling Blade
Black King Bar=Ogre Club+Mithril Hammer
Blade Mail=Broadsword+Chainmail+Robe of the Magi
Block of Cheese=Greater Healing Lotus+Cheese
Bloodthorn=Orchid Malevolence+Crystalys
Boots of Bearing=Tranquil Boots+Drum of Endurance
Buckler=Ring of Protection
Crimson Guard=Vanguard+Buckler
Crystalys=Broadsword+Blades of Attack
Dagon=Staff of Wizardry+Null Talisman
Daedalus=Crystalys+Demon Edge
Desolator=Mithril Hammer+Mithril Hammer
Diffusal Blade=Blade of Alacrity+Robe of the Magi
Disperser=Diffusal Blade+Demon Edge
Divine Rapier=Sacred Relic+Demon Edge
Dragon Lance=Ogre Club+Band of Elvenskin
Drum of Endurance=Robe of the Magi+Belt of Strength+Wind Lace
Echo Sabre=Oblivion Staff+Ogre Club
Eternal Shroud=Cloak+Ogre Axe+Ring of Health
Ethereal Blade=Kaya+Ghost Scepter
Eul's Scepter of Divinity=Staff of Wizardry+Sage's Mask+Wind Lace
Eye of Skadi=Ultimate Orb+Ultimate Orb+Point Booster
Falcon Blade=Fluffy Hat+Sage's Mask+Blades of Attack
Force Staff=Staff of Wizardry+Ring of Regen
Gleipnir=Maelstrom+Rod of Atos
Glimmer Cape=Shadow Amulet+Cloak
Great Healing Lotus=Healing Lotus
Greater Healing Lotus=Great Healing Lotus
Guardian Greaves=Arcane Boots+Mekansm
Hand of Midas=Gloves of Haste
Heart of Tarrasque=Reaver+Vitality Booster
Helm of the Dominator=Helm of Iron Will+Morbid Mask
Hood of Defiance=Ring of Health+Cloak
Hurricane Pike=Force Staff+Dragon Lance
Holy Locket=Diadem+Headdress+Magic Wand
Harpoon=Echo Sabre+Diadem
Headdress=Ring of Regen
Heaven's Halberd=Sange+Talisman of Evasion
Helm of the Overlord=Helm of the Dominator+Vladmir's Offering
Kaya=Staff of Wizardry+Robe of the Magi
Kaya and Sange=Sange+Kaya
Linken's Sphere=Perseverance+Ultimate Orb
Lotus Orb=Perserverance+Plate Mail
Maelstrom=Gloves of Haste+Mithril Hammer
Mjollnir=Maelstrom+Hyperstone
Monkey King Bar=Demon Edge+Javelin+Quarterstaff
Mage Slayer=Cloak+Oblivion Staff
Magic Wand=Magic Stick+Iron Branch
Manta Style=Yasha+Ultimate Orb
Mask of Madness=Morbid Mask+Quarterstaff
Medallion of Courage=Chainmail+Sage's Mask+Blight Stone
Mekansm=Meteor Hammer+Mind Breaker
Moon Shard=Hyperstone
Necronomicon=Sage's Mask+Belt of Strength (upgradeable)
Nullifier=Sacred Relic+Helm of Iron Will
Orchid Malevolence=Oblivion Staff+Oblivion Staff
Octarine Core=Void Stone+Soul Booster
Orb of Corrosion=Orb of Venom+Blight Stone+Fluffy Hat
Overwhelming Blink=Blink Dagger+Reaver
Pavise=Void Stone+Ring of Protection+Fluffy Hat
Perseverance=Ring of Health+Void Stone
Phase Boots=Boots of Speed+Chainmail+Blades of Attack
Phylactery=Diadem+Point Booster
Pipe of Insight=Cloak+Headdress+Ring of Health
Power Treads=Boots of Speed+Belt of Strength
Power Treads=Boots of Speed+Band of Elvenskin
Power Treads=Boots of Speed+Robe of the Magi
Radiance=Sacred Relic+Talisman of Evasion
Refresher Orb=Cornucopia
Rod of Atos=Staff of Wizardry+Vitality Booster
Sange=Ogre Club+Belt of Strength
Sange and Yasha=Sange+Yasha
Satanic=Morbid Mask+Reaver
Scythe of Vyse=Mystic Staff+Ultimate Orb
Shiva's Guard=Platemail+Mystic Staff
Silver Edge=Shadow Blade+Sange
Skull Basher=Javelin+Belt of Strength
Solar Crest=Medallion of Courage+Talisman of Evasion
Spirit Vessel=Urn of Shadows+Wind Lace
Shadow Blade=Shadow Amulet+Blitz Knuckles+Broadsword
Solar Crest=Medallion of Courage+Crown+Wind Lace
Tranquil Boots=Boots of Speed+Wind Lace+Ring of Regen
Urn of Shadows=Sage's Mask+Circlet+Ring of Protection
Vladimir's Offering=Ring of Basilius+Morbid Mask
Yasha=Blade of Alacrity+Boots of Elvenskin
Yasha and Kaya=Kaya+Yasha
Aetherforged Blade=Crystalys+Energy Booster
Bloodshroud Amulet=Vanguard+Morbid Mask
Cursed Essence=Ghost Scepter+Blade of Alacrity
Dire's Bane=Demon Edge+Demon Edge
Elemental Quiver=Wind Lace+Javelin
Essence of the Abyss=Ring of Health+Perseverance
Flameheart Ring=Ring of Basilius+Helm of Iron Will
Frostbound Gauntlets=Gloves of Haste+Orb of Venom
Gem of Resilience=Hood of Defiance+Vitality Booster
Ghostly Dagger=Blink Dagger+Ghost Scepter
Gravetide Boots=Arcane Boots+Guardian Greaves
Infernal Cane=Force Staff+Staff of Wizardry
Jungle Striders=Tranquil Boots+Iron Branch
Mystic Talisman=Yasha+Ultimate Orb
Nether Cloak=Shadow Amulet+Cloak
Obsidian Shield=Vanguard+Mystic Staff
Plaguebringer Staff=Diffusal Blade+Oblivion Staff
Radiant Crest=Medallion of Courage+Solar Crest
Sacred Vessel=Urn of Shadows+Spirit Vessel
Soulbound Scythe=Scythe of Vyse+Eul's Scepter of Divinity
Starshard Bow=Maelstrom+Yasha
Thunderstrike Warhammer=Sange+Mjollnir
Vanguard=Vitality Booster+Ring of Health
Veiled Blade=Echo Sabre+Ghost Scepter
Warlord's Gauntlets=Battle Fury+Skull Basher
Wyrmhide Shield=Dragon Lance+Vanguard
Xiphos of Agility=Crystalys+Yasha
Zenith Scroll=Aghanim's Scepter+Refresher Orb
Kaya Yasha Sange=Kaya and Sange+Yasha
A3=A2
A2=A1
A1=A3
A4=A3